R 900 600
C 219, 213, 213
F 188, 205, 206

111111111111111     11111111
100000000000001     10000001
100000000000001     10000001
100100010001001     10000001
100100010001001     10000001
100000010001001     10000001
100100000000001     10000001
100000000001001     10000001
1000000000010011111110000001
1000000000010000000000000001
1111111111111111111111111111