R 900 600
C 219, 213, 213
F 188, 205, 206
NO ./textures/redbrick.xpm
EA ./textures/greystone.xpm
SO ./textures/colorstone.xpm
WE ./textures/wood.xpm

1111111111111111111111111111111111111
1100000000000000000000000000000000001
1000000000000000000000000000000000001
1000000000000000000000000000000000001
1000000000000000000000000000000000001
1000000000000000000000000000000000001
1000000000000000000000000000000000001
1000000000000000000000000000000000001
1000000000000000000000000000000000001
10000000000000000N0000000000000000001
1000000000000000000000000000000000001
1000000000000000000000000000000000001
1000000000000000000000000000000000001
1000000000000000000000000000000000001
1000000000000000000000000000000000001
1000000000000000000000000000000000001
1000000000000000000000000000000000001
1000000000000000000000000000000000001
1111111111111111111111111111111111111