R 900 600
C 219, 213, 213
F 188, 205, 206
NO ./textures/redbrick.xpm

111111111111
11N000000001
100000000001
100000000001
100000000001
100000000001
110000000001
111111111111