R 900 600
C 219, 213, 213
F 188, 205, 206
NO ./textures/redbrick.xpm
EA ./textures/redbrick.xpm
SO ./textures/redbrick.xpm
WE ./textures/redbrick.xpm

S ./textures/barrel.xpm

1111111111111
1000000000201111
1000000002000201
10000000010S0001
10200000001011111
1200000001001
1000000001021
1000200000001
1000000000001
1000020000001
1000000000001
1000000000001
1000000000001
1000000000001
1000000000001
1111111111111
