R 800 950
C     90,90,3
11111
10001
11001
10001
11111