R 900 600
C 127, 190, 190
F 197, 197, 197

111111111111111
100000000000001
100100000000001
100100000000001
100100000000001
100000000000001
111111111111111