R 900 600
NO ./textures/greystone.xpm
EA ./textures/greystone.xpm
SO ./textures/wood.xpm
WE ./textures/redbrick.xpm
S ./textures/barrel.xpm
F 188, 205, 206
C 219, 213, 213

1111111111111
1000000000201111
1000000000000001
1000000001000001
10200000001011111
1200000001001
1000000001021
1000000000001
1000000000001
1000020000001
1000000200001
1000000000001
12000N0000001
1000000000001
1000000000001
1111111111111