R 900 600
C 219, 213, 213
F 188, 205, 206
NO ./textures/redbrick.xpm
EA ./textures/greystone.xpm
SO ./textures/colorstone.xpm
WE ./textures/wood.xpm

S ./textures/barrel.xpm

1111111111111
1000200000001111
102000E000000001
1000000001000001
1020002001001111
1000000001001
1000020001001
1111111111111
