R 900 600
C 219, 213, 213
F 188, 205, 206
NO ./textures/redbrick.xpm
EA ./textures/greystone.xpm
SO ./textures/colorstone.xpm
WE ./textures/wood.xpm

111111
110001
100001
100001
100001
100001
100001
100001
100001
100001
1N0001
100001
100001
100001
100001
100001
100001
100001
100001
100001
111111
