R 900 600
C 219, 213, 213
F 188, 205, 206

111111111111111
100000000000001
100100000000001
100100000000001
100100000000001
100000000000001
111111111111111