111111111111111111111111
100000000000000000000001
100000000000000000000001
100000000000000000000001
100000111110000100000001
100000100010000000000001
100000100010000101010001
100000100010000000000001
100000110110000101010001
100000000000000000000001
100000000000000000000001
100000000000000000000001
100000000000000000000001
100000000000000000000001
100000000000000000000001
100000000000000000000001
111111111000000000000001
100000001000000000000001
111000001000000000000001
100000001000000000000001
110011111000000000100001
100000000000000000100001
100000000000000000100001
111111111111111111111111