R 900 600
C 219, 213, 213
F 188, 205, 206
NO ./textures/redbrick.xpm

111111111
120000001
100000001
100000001
100000001
100000001
1S0000001
100000001
100000001
100000001
100000001
120000001
111111111