R 900 600
C 219, 213, 213
F 188, 205, 206
NO ./textures/redbrick.xpm
EA ./textures/redbrick.png
SO ./textures/redbrick.xpm
WE ./textures/redbrick.xpm

S ./textures/barrel.xpm

1111111111111
1000000000201111
100000E002000201
1000000001000001
10000000001001111
1000000001001
1000000001021
1111111111111
