R 900 600
C 219, 213, 213
F 188, 205, 206
NO ./textures/redbrick.xpm

111111
120001
100001
100001
100001
100001
1S0001
100001
100001
100001
100001
120001
111111