R 900 600
C 127, 190, 190
F 197, 197, 197

111111111111111111111111
100001110010000000000001
100000100000000000000001
100000000111000000000001
100000000101000000000001
100000000001000000000001
101000000000000000000001
100000000000000000100001
101000000000000000000001
100000000000000111100001
100000000000000000000001
100000000100010000000001
100000000100010000000001
100000000111110000000001
100000000000000000000001
111111111111111111111111