R 900 600
NO ./textures/redbrick.xpm
EA ./textures/colorstone.xpm
SO ./textures/redbrick.xpm
WE ./textures/redbrick.xpm
S ./textures/barrel.xpm
F 147, 159, 153
C 219, 213, 213

1111111111
1000000001
1000000001
1000N00001
1000000001
1000000001
1111111111