R 600 900
NO ./textures/redbrick.xpm
EA ./textures/colorstone.xpm
SO ./textures/redbrick.xpm
WE ./textures/redbrick.xpm
S ./textures/barrel.xpm
F 147, 159, 153
C 219, 213, 213

111111111
100000001
100S00001
10000S001
111111111