R 600 900
NO ./textures/redbrick.xpm
EA ./textures/colorstone.xpm
SO ./textures/redbrick.xpm
WE ./textures/redbrick.xpm
S ./textures/barrel.xpm
F 147, 159, 153
C 219, 213, 213

111111111
10AAA0001
1000N0001
100000001
111111111
